W0W0W0W0W0W0W0W0W0W0W0W0W0W0W0W0W0W0W0W0W0W0W0W0W0W0W0W0W0W0W0W0W0W0W0W0W0W0W0W0W0W0W0W0W0W0W0W0W0W0
W0W1W2W3F0F0F0F0F0F0F0F0F0F0F0F0F0F0F0F0F0F0F0F0F0F0F0F0F0F0F0F0F0F0F0F0F0F0F0F0F0F0F0F0F0F0F0F0F0W0
W0F0F0F0F0F0F0F0F0F0F0F0F0F0F0F0F0F0F0F0F0F0F0F0F0F0F0F0F0F0F0F0F0F0F0F0F0F0F0F0F0F0F0F0F0F0F0F0F0W0
W0F0F0F0F0F0F0F0F0F0F0F0F0F0F0F0F0F0F0F0F0F0F0F0F0F0F0F0F0F0F0F0F0F0F0F0F0F0F0F0F0F0F0F0F0F0F0F0F0W0
W0F0F0F0F0F0F0F0F0F0F0F0F0F0F0F0F0F0F0F0F0F0F0F0F0F0F0F0F0F0F0F0F0F0F0F0F0F0F0F0F0F0F0F0F0F0F0F0F0W0
W0F0F0F0F0F0F0F0F0F0F0F0F0F0F0F0F0F0F0F0F0F0F0F0F0F0F0F0F0F0F0F0F0F0F0F0F0F0F0F0F0F0F0F0F0F0F0F0F0W0
W0F0F0F0F0F0F0F0F0F0F0F0F0F0F0F0F0F0F0F0F0F0F0F0F0F0F0F0F0F0F0F0F0F0F0F0F0F0F0F0F0F0F0F0F0F0F0F0F0W0
W0F0F0F0F0F0F0F0F0F0F0F0F0F0F0F0F0F0P0P0P0P0P0P0P0P0F0F0F0F0F0F0F0F0F0F0F0F0F0F0F0F0F0F0F0F0F0F0F0W0
W0F0F0F0F0F0F0F0F0F0F0F0F0F0F0F0F0F0P0F0F0F0F0F0F0E0P0F0F0F0F0F0F0F0F0F0F0F0F0F0F0F0F0F0F0F0F0F0F0W0
W0F0F0F0F0F1F0F0F0F0F0F0F0F0F0F0F0F0P0F0P0P0P0P0P0P0F0F0F0F0F0F0F0F0F0F0F0F0F0F0F0F0F0F0F0F0F0F0F0W0
W0F0F0F0F0F0F0F0F0F0F0F0F0F0F0F0F0F0P0F0P0F0P0F0F0F0F0F0F0F0F0F0F0F0F0F0F0F0F0F0F0F0F0F0F0F0F0F0F0W0
W0F0F0F0F0F0F0F0F0F0F0F0F0F0F0F0F0F0P0F0F0F0F0P0F0F0F0F0F0F0F0F0F0F0F0F0F0F0F0F0F0F0F0F0F0F0F0F0F0W0
W0F0F0F0F0F0F0F0F0F0F0F0F0F0F0F0F0F0P0F0F0F0F0P0F0F0F0F0F0F0F0F0F0F0F0F0F0F0F0F0F0F0F0F0F0F0F0F0F0W0
W0F0F0F0F0F0F0F0F0F0F0F0F0F0F0F0F0F0P0P0P0P0F0P0P0P0F0F0F0F0F0F0F0F0F0F0F0F0F0F0F0F0F0F0F0F0F0F0F0W0
W0F0F0F0F0F0F0F0F0F0F0F0F0F0F0F0F0F0F0F0F0P0F0F0F0F0P0P0F0F0F0F0F0F0F0F0F0F0F0F0F0F0F0F0F0F0F0F0F0W0
W0F0F0F0F0F0F0F0F0F0F0F0F0F0F0F0F0F0F0F0F0P0F0P0P0F0P0F0P0F0F0F0F0F0F0F0F0F0F0F0F0F0F0F0F0F0F0F0F0W0
W0F0F0F0F0F0F0F0F0F0F0F0F0F0F0F0F0W0W0F0F0P0F0P0P0F0F0F0P0F0F0F0F0F0F0F0F0F0F0F0F0F0F0F0F0F0F0F0F0W0
W0F0F0F0F0F0F0F0F0F0F0F0F0F0F0F0W1F0F0W0F0L0F0L0F0P0P0P0F0F0F0F0F0F0F0F0F0F0F0F0F0F0F0F0F0F0F0F0F0W0
W0F0F0F0F0F0F0F0F0F0F0F0F0F0F0W1F0F0P0W0W1W2D4W2W1W0F0F0W0F0F0F0F0F0F0F0F0F0F0F0F0F0F0F0F0F0F0F0F0W0
W0F0F0F0F0F0F0F0F0F0F0F0F0F0F0P0F0G0F0W0F0F0F0F0F0W2F0W0F0W0F0F0F0F0F0F0F0F0F0F0F0F0F0F0F0F0F0F0F0W0
W0F0F0F0F0F0F0F0F0F0F0F0F0F0P0F0F0P0F0W1F0W2K4W2F0W3L0F0F0F0W0F0F0F0F0F0F0F0F0F0F0F0F0F0F0F0F0F0F0W0
W0F0F0F0F0F0F0F0F0F0F0F0F0W2P0F0F0P0F0D3F0K3B0K1F0D1F0F0Z0F0F0W0F0F0F0F0F0F0F0F0F0F0F0F0F0F0F0F0F0W0
W0F0F0F0F0F0F0F0F0F0F0F0F0F0P0F0F0P0F0W1F0W2K0W2F0W3L0F0F0F0W0F0F0F0F0F0F0F0F0F0F0F0F0F0F0F0F0F0F0W0
W0F0F0F0F0F0F0F0F0F0F0F0F0F0F0P0F0P0F0W0F0F0F0F0F0W2F0W0F0W0F0F0F0F0F0F0F0F0F0F0F0F0F0F0F0F0F0F0F0W0
W0F0F0F0F0F0F0F0F0F0F0F0F0F0F0W1F0F0P0W0W3W0D0W0W3W0F0F0W0F0F0F0F0F0F0F0F0F0F0F0F0F0F0F0F0F0F0F0F0W0
W0F0F0F0F0F0F0F0F0F0F0F0F0F0F0F0W1F0F0W0A0F0F0F0A0W0F0F0F0F0F0F0F0F0F0F0F0F0F0F0F0F0F0F0F0F0F0F0F0W0
W0F0F0F0F0F0F0F0F0F0F0F0F0F0F0F0F0W0W0W0A0W1W3W2A0W0F0F0F0F0F0F0F0F0F0F0F0F0F0F0F0F0F0F0F0F0F0F0F0W0
W0F0F0F0F0F0F0F0F0F0F0F0F0F0F0F0F0F0F0W0A0A0A0A0A0W0F0F0F0F0F0F0F0F0F0F0F0F0F0F0F0F0F0F0F0F0F0F0F0W0
W0F0F0F0F0F0F0F0F0F0F0F0F0F0F0F0F0F0F0W0A0A0A0A0A0W0F0F0F0F0F0F0F0F0F0F0F0F0F0F0F0F0F0F0F0F0F0F0F0W0
W0F0F0F0F0F0F0F0F0F0F0F0F0F0F0F0F0F0F0W0A0A0A0A0A0W0F0F0F0F0F0F0F0F0F0F0F0F0F0F0F0F0F0F0F0F0F0F0F0W0
W0F0F0F0F0F0F0F0F0F0F0F0F0F0F0F0F0F0F0W0W0W0W0W0W0W0F0F0F0F0F0F0F0F0F0F0F0F0F0F0F0F0F0F0F0F0F0F0F0W0
W0F0F0F0F0F0F0F0F0F0F0F0F0F0F0F0F0F0F0F0F0F0F0F0F0F0F0F0F0F0F0F0F0F0F0F0F0F0F0F0F0F0F0F0F0F0F0F0F0W0
W0F0F0F0F0F0F0F0F0F0F0F0F0F0F0F0F0F0F0F0F0F0F0F0F0F0F0F0F0F0F0F0F0F0F0F0F0F0F0F0F0F0F0F0F0F0F0F0F0W0
W0F0F0F0F0F0F0F0F0F0F0F0F0F0F0F0F0F0F0F0F0F0F0F0F0F0F0F0F0F0F0F0F0F0F0F0F0F0F0F0F0F0F0F0F0F0F0F0F0W0
W0F0F0F0F0F0F0F0F0F0F0F0F0F0F0F0F0F0F0F0F0F0F0F0F0F0F0F0F0F0F0F0F0F0F0F0F0F0F0F0F0F0F0F0F0F0F0F0F0W0
W0F0F0F0F0F0F0F0F0F0F0F0F0F0F0F0F0F0F0F0F0F0F0F0F0F0F0F0F0F0F0F0F0F0F0F0F0F0F0F0F0F0F0F0F0F0F0F0F0W0
W0F0F0F0F0F0F0F0F0F0F0F0F0F0F0F0F0F0F0F0F0F0F0F0F0F0F0F0F0F0F0F0F0F0F0F0F0F0F0F0F0F0F0F0F0F0F0F0F0W0
W0F0F0F0F0F0F0F0F0F0F0F0F0F0F0F0F0F0F0F0F0F0F0F0F0F0F0F0F0F0F0F0F0F0F0F0F0F0F0F0F0F0F0F0F0F0F0F0F0W0
W0F0F0F0F0F0F0F0F0F0F0F0F0F0F0F0F0F0F0F0F0F0F0F0F0F0F0F0F0F0F0F0F0F0F0F0F0F0F0F0F0F0F0F0F0F0F0F0F0W0
W0F0F0F0F0F0F0F0F0F0F0F0F0F0F0F0F0F0F0F0F0F0F0F0F0F0F0F0F0F0F0F0F0F0F0F0F0F0F0F0F0F0F0F0F0F0F0F0F0W0
W0F0F0F0F0F0F0F0F0F0F0F0F0F0F0F0F0F0F0F0F0F0F0F0F0F0F0F0F0F0F0F0F0F0F0F0F0F0F0F0F0F0F0F0F0F0F0F0F0W0
W0F0F0F0F0F0F0F0F0F0F0F0F0F0F0F0F0F0F0F0F0F0F0F0F0F0F0F0F0F0F0F0F0F0F0F0F0F0F0F0F0F0F0F0F0F0F0F0F0W0
W0F0F0F0F0F0F0F0F0F0F0F0F0F0F0F0F0F0F0F0F0F0F0F0F0F0F0F0F0F0F0F0F0F0F0F0F0F0F0F0F0F0F0F0F0F0F0F0F0W0
W0F0F0F0F0F0F0F0F0F0F0F0F0F0F0F0F0F0F0F0F0F0F0F0F0F0F0F0F0F0F0F0F0F0F0F0F0F0F0F0F0F0F0F0F0F0F0F0F0W0
W0F0F0F0F0F0F0F0F0F0F0F0F0F0F0F0F0F0F0F0F0F0F0F0F0F0F0F0F0F0F0F0F0F0F0F0F0F0F0F0F0F0F0F0F0F0F0F0F0W0
W0F0F0F0F0F0F0F0F0F0F0F0F0F0F0F0F0F0F0F0F0F0F0F0F0F0F0F0F0F0F0F0F0F0F0F0F0F0F0F0F0F0F0F0F0F0F0F0F0W0
W0F0F0F0F0F0F0F0F0F0F0F0F0F0F0F0F0F0F0F0F0F0F0F0F0F0F0F0F0F0F0F0F0F0F0F0F0F0F0F0F0F0F0F0F0F0F0F0F0W0
W0F0F0F0F0F0F0F0F0F0F0F0F0F0F0F0F0F0F0F0F0F0F0F0F0F0F0F0F0F0F0F0F0F0F0F0F0F0F0F0F0F0F0F0F0F0F0F0F0W0
W0F0F0F0F0F0F0F0F0F0F0F0F0F0F0F0F0F0F0F0F0F0F0F0F0F0F0F0F0F0F0F0F0F0F0F0F0F0F0F0F0F0F0F0F0F0F0F0F0W0
W0W0W0W0W0W0W0W0W0W0W0W0W0W0W0W0W0W0W0W0W0W0W0W0W0W0W0W0W0W0W0W0W0W0W0W0W0W0W0W0W0W0W0W0W0W0W0W0W0W0
