W W W W
W F F W
W F F W
W F W W
W F W W
W F W W
W F W W
W F W W
W F W W
W W W W
