W W F F W F F F F F F F W W W F F F F F F F F
W W F F F F F F F F F F W W F F F W F F F F F
W F F F G W F F F F F F W W F F F W W W F F F
F F F F F F F F F F F F W W F F F F F W F F F
F F F F F F F F F F F W W F F F F F W W F F F
F F F F F F F F W F F W F F F W W W W W W W W
F F W F F F F F W F F F F F F F F F F F F F F
F F W F F F F W W W F F F F F F F F F W F F F
F F W F F F W W W W W F F F F F F F F W W F F
F F F W F F W W W W W F F F F F F W W W W F F