WWWWWWWWWWWWWWWWWWWWWWWWWWWWWWWWWWWWWWWWWWWWWWWWWW
WWWWWWWWWWWWWWWWWWWWWWWWWEWWFFFFFFFFFFFFFFWWWWWWWW
WWWWWWWWWWFFFFFFWWWWWFFFFFFFFFFFFFFFFFFFFFFFFFWWWW
WWWWWFFFFFFFFFFFFWWWWWFFFFFFFFFFFFFFFFFLLFFAFFFWWW
WWWFFFFFFFFFFFFFFFWWWWWWFFFFFFFFFFFFWWWWAFFFFFZFWW
WWWFFFFFFFFFFFFFGFFWWWWWFFWWWWWFFFFFWWWWFFPPPPPFWW
WWFFFFFFFFFWFFFFFFFWWWWWPPWFFWWWWGGGWFFPPPPFFFPFWW
WWFFFFFFFFFFWFFFFFFWWWFFFFFFFFWWWWWGGFFPAPPPPFPFWW
WWFFFFFFFFFFFFWLFFFWWFFFFFFFFFWWWWWWFFFPFPFLPFPFPW
WFFFFFFFFFFFFFWFFFFWWFFFFFFFFFFFFFWWWWWWFPFPPFPFPW
WFFFFFFGFFFFFFFWFFFWWFFFFFFFFFFFFFWWWWWWFFFFFFFFPW
WFFFFFFFFFFFFFFFFFWWWWFFFFFFFFFFFFWWWWWWPPPPPFPPPW
WFFFFFFFFFFFFFFFFFWWWWFFFFFFFFFFFFFWWWFFFFFFFFFFWW
WFWFFFFWAWFFFFFFFWWWWWD0WPPWWWFFFFFFFFFFFFFFFFFFWWW
WFK0WFFFFWFFFFFFFFWWWFFFFFFFFWWFFFFFFFFFFFWWWWWWWWW
WFWFFFFFFFFFFFFFWFFFFFFFK.FFFFWWFFFFFFFFWWWWFFWWWWW
WFFFFGFFFFFFFFFWFFFFFFFFFFFFFFWWFFFFWWWWZFFFFFWWWW
WFFFFFFFFFFFFFFWFFFFFFFFFFFFFFFWWWWWWWWCZFFFFFWWWW
WFFFFFFFFFFFFFWFFFFFFFFFFFFFFFFFWWWWWLLFFFFFFFFWWW
WFFFGFFFFFFFFFWFFFFFFFFFFFFFFFFFFWWAAFFFWFFFFFFWWW
WFFFFFFFFFFFFFWFFFFFFFFFFFFFFFFFFWWWWWWWFFFFFFFFWW
WFFFFFFFFFFFFFD0FFFFFFFFFFFFFFFFFFD.FFFFFFFFFWFFFFWW
WFFFWWFFFFFFFFWFFFFFFFFFFFFFFFFFFWFFFFFFFFWFFFFWWW
WFFFFAWFFFFFFFWFFFFFFFFFBFFFFFFFFWFFFFFFFFWFFGFWWW
WFGFFFWFFFFFFFFWFFFFFFFFFFFFFFFFWWWFFFFFFFWFFFFWWW
WFFFFFFFFFFFFFFWFFFFFFFFFFFFFFFWWWWWPPPWWWFFFFFWWW
WWFFFFFFFFFFFFFWFFFFFFFFFFFFFFFWWWWWFFFWFFFFFFFFWW
WWFFFFFFFFFFWFFWFFFFFFFFFFFFFFFWWWWWFK/FWFFFFFFFWWW
WWFFFFFFFFFWAFFWFFFFFFFFFFFFFWD/WWFWWFFFZFFFFFFWWWW
WWWFFFFFFFFWFFFFWFFFFFFFFFFFWFFFFFPWWWFZFFWWWWWWWW
WWWFFFFFFFFWFFFFWFFFFFFFFFFWFFFFFFPFWWWWWWWWWWWWWW
WWWFFWFFFFFFFFWWWFFFFFFFFFWFPFFFFFPFFFFFFFFFWWWWWW
WWWFFLWFFFFFWWFFFWFFFFFFFFWFPPPPFPPFFFPPPPFFFWWWWW
WWWFFFFWFFWWFFWPPWFFFFFFFWWFFPFFFFPFPPPFFPPAFFWWWW
WWWFFFFFFWWFFFFFFFWWWWWD0WFWFFPFFPPPFPAPFFFPPFFFWWW
WWWWFFFFFWFPPWPCPPFFFWPFPFWFFPPFPFFFPFPFPFFFFFPFWW
WWWWFFFFWWFPFFFFPPPPFFFFPFFWFFPFPFPPPFPFPPPPPFPFWW
WWWWWFWWWFWPFFFFFPFPCPPCPFFFWWPFFFFFFFPFFFFFPFPFWW
WWWWWWFFFPPFCPPWFPFWFFPFPPWPFWPPPPPFPPPPPK0FFPFPFWW
WWWWWWFFPPFFPFFPFPFPFFPFFFFPFFWWFFPFPFFFPPPFPPPFWW
WWWWWWWFCFFPFFWPCPFPFFPWPFFPPFFWFFPCPFPFPFPFFFFFWW
WWWWWWWCPPFPFFFFFPFPPCPPPPCPPFFWPPPFPFPFPFPFPPPFWW
WWWWWWWFFPFFPPFFFFPPPFPWPPFFPFFWPFFFFFPFZFPFPFFFWW
WWWFWWWFFWPFFPPPFFFCFFFFCFFFPFFWPFPPPFPFPPPFPFFWWW
WWFFFWWFFFWPFCFFPPPPPPPPPPFFFPFWPFPLFFFFFFFFPFWWWW
WWFK0FFWFFFFPPPFFFPFFFFFFFPPFFFPFWFFFPPPFPPPFFWWWWW
WWWFFFWWPPPWFFPPFFCPWPPPFPWPPCPFFWFFFFFFLFFFFWWWWW
WWWWFFFFFFFFPPPPPWPPPWPPCPFWWFFFFFWFFFFFFFFWWWWWWW
WWWWWWWWWWPFFFFCFFFFFFFFFPFFFFFFFFFWWWWWWWWWWWWWWW
WWWWWWWWWWWWWWWWWWWWWWWWWWWWWWWWWWWWWWWWWWWWWWWWWW
