WWFFWFFFFFFFWWWFFFFFFFFw
WWFFFFFFFFFFWWFFFWFFFFF
WFFFGGGFFFFFWWFFFWWWFFF
FFFFGFGFFFFFWWFFFFFWFFF
FFFFGGGFFFFWWFFFFFWWFFF
FFFFFFFFWFFWFFFWWWWWWWW
FFFFFFFFWFFFFFFFFFFFFFF
FFFFFFFFWWFFFFFFFFFWFFF
FFFFFFWFWWWFFFFFFFFWWFF
FFFWFFFFWWWFFFFFFWWWWFF
