WWWWWWWWWWWWWWWWWWWWWW
WBFFFFFFFFFFFFFFFFFFFW
WFEFFFFFFFFFFFFFFFFFFW
WFFFFFFFFFFFFFFFFFFFFW
WFFFFFFFFFFFFFFFFFFFFW
WFFFFFFFFFFFFFFFFFFFFW
WFFFFFFFFFFFFFFFFFFFFW
WFFFFFFFFFFFFFFFFFFFFW
WFFFFFFFFFFFFFFFFFFFFW
WFFFFFFFFFFFFFFFFFFFFW
WFFFFFFFFFFFFFFFFFFFFW
WFFFFFFFFFFFFFFFFFFFFW
WFFFFFFFFFFFFFFFFFFFFW
WFFFFFFFFFFFFFFFFFFFFW
WFFFFFFFFFFFFFFFFFFFFW
WFFFFFFFFFFFFFFFFFFFFW
WFFFFFFFFFFFFFFFFFFFFW
WFFFFFFFFFFFFFFFFFFFFW
WFFFFFFFFFFFFFFFFFFFFW
WFFFFFFFFFFFFFFFFFFFFW
WFFFFFFFFFFFFFFFFFFFFW
WFFFFFFFFFFFFFFFFFFFFW
WFFFFFFFFFFFFFFFFFFFFW
WFFFFFFFFFFFFFFFFFFFFW
WFFFFFFFFFFFFFFFFFFFFW
WFFFFFFFFFFFFFFFFFFFFW
WFFFFFFFFFFFFFFFFFFFFW
WFFFFFFFFFFFFFFFFFFFFW
WFFFFFFFFFFFFFFFFFFFFW
WFFFFFFFFFFFFFFFFFFFFW
WFFFFFFFFFFFFFFFFFFFFW
WFFFFFFFFFFFFFFFFFFFFW
WFFFFFFFFFFFFFFFFFFFFW
WFFFFFFFFFFFFFFFFFFFFW
WFFFFFFFFFFFFFFFFFFFFW
WFFFFFFFFFFFFFFFFFFFFW
WFFFFFFFFFFFFFFFFFFFFW
WFFFFFFFFFFFFFFFFFFFFW
WFFFFFFFFFFFFFFFFFFFFW
WWWWWWWWWWWWWWWWWWWWWW
