W0W0W0W0W0W0W0W0W0W0W0W0W0W0W0W0W0W0W0W0W0W0W0W0W0W0W0W0W0W0W0W0W0W0W0W0W0W0W0W0W0W0W0W0W0W0W0W0W0W0
W0W0W0W0W0F0F0F0F0W0W0W0F0F0F0F0F0F0F0W0W0W0W0F0F0F0F0F0F0F0F0F0W0W0W0F0F0F0W0L0A0L0F0F0F0F0F0F0F0W0
W0W0W0W0F0F0F0F0F0F0F0F0F0F0W0F0F0F0F0F0W0W0W0W0W0F0G0W0W0F0F0F0F0W0W0W0F0W0W0F0G0F0F0F0F0F0F0F0F0W0
W0W0W0F0B0F0F0C0K0F0F0F0F0F0P0F0F0G0F0F0F0D0F0F0W0W0F0L0L0W0F0F0F0W0F0P0F0F0W0G0F0G0F0W0W0W0W0F0F0W0
W0W0W0W0F0F0F0F0F0F0F0F0F0F0W0F0F0F0F0F0W0W0F0F0F0W0W0W0A0W0W0F0F0F0F0P0F0F0W0P0P0P0W0F0F0W0W0F0F0W0
W0F0F0L0W0F0F0F0F0W0W0W0F0F0F0F0F0F0F0W0W0W0W0F0F0F0F0F0W0F0F0F0W0F0F0W0F0F0P0F0F0F0F0F0F0F0W0F0F0W0
W0F0W0W0W0W0W0W0W0W0W0W0W0W0W0W0W0W0W0W0W0W0W0W0F0F0W0F0F0F0F0F0P0F0F0F0F0F0P0F0F0F0F0F0F0F0F0F0F0W0
W0F0F0F0F0F0P0L0F0P0F0F0F0F0F0P0F0F0F0W0W0W0W0W0F0F0P0F0W0P0P0P0W0F0W0F0W0F0W0F0F0W0W0F0F0F0F0F0F0W0
W0F0P0P0P0F0P0P0F0P0F0P0P0P0F0P0P0F0F0W0W0W0W0W0F0F0P0F0F0G0F0F0F0F0P0F0F0F0F0F0W0W0W0W0F0F0F0F0F0W0
W0F0F0F0P0P0P0F0F0F0F0F0F0P0F0F0P0F0F0W0W0W0W0F0F0F0W0F0F0F0F0F0F0F0P0F0F0F0W0F0F0W0W0W0W0F0F0F0F0W0
W0F0P0F0F0F0F0F0P0P0P0F0P0P0P0F0F0F0F0W0W0W0W0W0F0F0F0F0W0P0P0W0P0P0W0P0W0F0P0F0W0W0W0W0W0F0F0F0L0W0
W0P0P0P0P0P0F0P0F0F0F0F0P0F0F0F0P0P0W0W0W0W0W0W0W0F0F0F0F0F0F0W0L0F0W0F0F0F0P0F0F0W0W0W0F0F0F0F0F0W0
W0P0F0F0F0P0F0P0F0P0P0K5P0F0P0P0P0F0F0W0W0W0W0W0W0W0W0W0W0W0W0W0W0F0F0F0W0F0P0F0F0W0W0W0F0F0F0F0W0W0
W0F0F0P0F0F0F0P0F0G0P0P0P0F0P0F0P0F0F0W0W0W0W0W0W0F0F0F0F0F0G0F0G0W0W0W0W0W0W0W0W0L0L0W0F0F0F0W0W0W0
W0F0P0P0P0F0P0P0P0F0P0F0P0F0F0F0F0F0F0F0D4F0D3F0D2F0F0F0F0F0F0W0P0W0W0W0W0W0W0A0A0F0F0L0W0F0F0W0W0W0
W0F0P0L0P0F0F0F0P0P0P0F0F0F0P0P0P0F0F0W0W0W0W0W0W0F0F0F0F0F0F0F0F0F0F0F0F0F0F0F0F0F0F0F0P0F0F0F0W0W0
W0F0P0F0F0F0P0F0F0F0P0F0P0F0F0F0F0F0F0W0W0W0W0W0W0W0W0W0W0F0F0F0F0C0F0F0F0F0F0F0F0F0F0L0W0W0F0F0F0W0
W0W0W0W0W0W0W0W0W0D5W0W0W0W0W0W0W0W0W0W0W0W0W0W0W0W0W0W0W0F0F0F0F0F0F0F0F0F0F0W0W0F0W0W0W0W0W0F0L0W0
W0W0W0W0W0F0F0F0F0C0F0F0L0L0W0W0W0W0W0W0W0W0W0W0W0W0W0W0W0W0W0W0W0W0W0W0W0W0W0F0F0F0F0F0F0F0P0F0F0W0
W0W0W0W0F0F0F0F0F0F0F0F0F0F0L0W0W0W0W0W0W0W0W0F0F0F0F0W0W0W0W0F0F0D8E0W0W0K3F0F0F0W0F0G0F0F0P0F0L0W0
W0W0W0W0F0F0W0W0F0F0F0W0W0F0F0W0W0W0W0W0C0W0F0F0F0F0F0F0F0W0W0D7W0W0W0W0W0W0F0G0F0P0F0F0F0F0P0F0F0W0
W0W0W0W0F0F0W0W0F0F0F0W0W0F0F0W0W0W0W0W0W0F0F0F0F0W0F0F0F0F0F0F0F0F0F0W0W0W0W0F0W0W0W0F0F0F0W0F0F0W0
W0W0W0W0F0F0F0F0F0F0F0F0F0F0F0W0W0W0W0W0F0F0F0F0W0F0W0F0F0F0F0F0F0F0F0F0F0W0L0F0F0F0K4W0F0F0P0F0A0W0
W0F0F0A0W0F0F0F0F0F0F0F0F0F0W0W0W0W0W0F0F0F0G0W0F0F0F0F0F0F0F0F0F0F0F0F0F0W0F0F0G0F0F0F0F0F0P0F0F0W0
W0F0F0F0W0F0F0W0W0F0W0W0F0F0W0W0W0W0W0F0F0F0F0F0W0F0F0F0F0F0W0W0G0W0F0F0W0K2F0F0F0F0F0F0F0F0P0F0K1W0
W0L0F0F0W0F0F0W0W0F0W0W0F0F0W0W0W0W0W0W0F0F0F0W0F0F0L0W0F0F0F0F0W0F0F0F0F0W0F0F0W0L0W0W0F0F0W0F0W0W0
W0W0W0F0W0F0F0F0F0F0F0F0F0F0W0W0W0W0W0W0W0A0F0F0F0W0W0F0F0F0W0F0F0F0F0F0W0W0W0F0G0W0F0F0F0W0W0D1W0W0
W0W0W0F0F0F0F0F0F0F0F0F0F0F0F0W0W0W0W0W0W0W0F0F0F0F0F0F0F0W0F0F0F0F0W0W0W0W0W0W0F0F0F0F0F0F0F0G0W0W0
W0W0W0W0F0F0W0W0F0F0F0W0W0F0F0W0W0W0W0W0W0W0F0F0F0F0F0F0F0F0F0F0F0W0W0A0F0A0W0W0W0W0F0F0F0F0F0F0W0W0
W0W0W0W0F0F0W0W0F0F0F0W0W0F0F0W0W0W0W0W0W0W0W0W0F0F0F0W0F0F0F0W0F0F0F0F0F0F0W0W0W0W0W0W0F0F0W0W0W0W0
W0W0W0W0F0F0F0F0F0F0F0F0F0F0F0W0W0W0W0W0W0A0A0W0W0K7W0F0F0F0F0W0F0F0F0F0F0F0F0W0W0W0W0W0W0W0W0W0W0W0
W0W0W0W0W0F0F0F0F0F0F0F0F0F0W0A0F0F0W0F0F0F0F0F0L0W0F0F0F0F0F0L0W0F0F0F0F0G0F0F0W0W0W0W0W0W0W0W0W0W0
W0W0W0W0W0F0F0W0W0F0W0W0F0F0W0F0F0F0W0F0G0F0G0F0L0W0F0F0W0W0F0F0F0W0F0F0F0W0W0F0W0W0W0W0W0W0W0W0W0W0
W0W0W0W0W0F0F0W0W0F0W0W0F0F0W0F0F0L0W0F0F0F0F0F0L0W0F0F0F0F0W0F0F0F0F0F0F0F0F0F0F0W0W0L0W0W0W0W0W0W0
W0W0W0W0W0F0F0F0F0F0F0F0F0F0W0F0W0W0W0F0F0F0F0F0W0W0W0F0F0G0W0F0F0F0F0W0F0F0W0F0F0W0F0F0F0F0W0W0W0W0
W0W0W0W0F0F0F0F0F0F0F0F0F0F0F0F0W0W0W0F0F0W0P0P0W0W0W0W0F0F0F0W0F0F0W0G0W0F0F0F0F0F0F0F0F0F0W0W0W0W0
W0W0W0W0F0F0W0W0F0F0F0W0W0F0F0W0W0W0W0W0F0F0F0F0F0F0F0F0W0F0F0F0F0F0F0F0F0F0F0L0W0F0F0F0F0F0F0W0W0W0
W0W0W0W0F0F0W0W0F0F0F0W0W0F0F0W0W0W0W0W0W0W0W0W0W0W0W0F0F0W0F0W0W0W0F0F0A0W0F0W0F0F0W0F0W0F0F0W0W0W0
W0W0W0W0F0F0F0F0F0F0F0F0F0F0F0W0W0W0W0W0W0W0W0W0W0W0W0F0F0F0F0W0W0W0W0F0W0F0F0W0F0K8W0F0F0W0G0F0W0W0
W0W0W0W0W0F0F0F0F0F0F0F0F0F0W0W0W0W0W0W0W0W0W0W0W0W0W0F0F0F0W0W0W0W0W0F0F0F0F0F0F0W0F0F0F0F0W0F0W0W0
W0W0W0W0W0W0W0F0F0F0F0F0W0W0W0W0W0W0W0W0W0W0W0W0W0W0W0L0C0L0W0W0W0W0W0W0F0F0F0F0F0F0F0L0W0F0F0F0W0W0
W0W0W0W0W0W0W0W0W0F0W0W0W0W0W0W0W0W0W0W0W0W0W0W0W0W0W0W0W0W0W0W0W0W0W0W0W0F0F0F0W0F0F0W0L0F0F0F0W0W0
W0F0F0F0F0F0F0F0F0F0F0F0F0F0F0F0F0F0F0F0F0F0F0F0F0F0F0F0F0F0W0W0W0W0W0W0L0F0F0W0F0F0F0F0F0F0F0W0W0W0
W0F0W0W0W0W0F0F0F0W0W0W0F0F0F0W0F0W0F0F0F0W0F0W0F0F0W0G0W0F0W0W0W0W0W0F0W0F0F0W0G0F0F0W0F0F0F0W0W0W0
W0F0W0L0F0L0W0F0W0F0P0F0W0F0W0F0G0F0W0F0W0G0W0G0W0F0W0W0W0F0W0W0W0W0F0F0F0W0F0F0W0F0F0F0W0A0W0W0W0W0
W0F0W0F0F0F0W0F0F0G0P0G0F0F0W0P0P0P0W0F0W0F0W0F0W0F0W0W0W0F0F0D6F0F0F0G0F0F0F0F0F0F0F0F0W0W0W0W0W0W0
W0F0F0G0F0F0W0F0W0F0P0F0W0F0W0F0G0F0W0F0F0F0K6F0F0F0W0W0W0F0W0W0W0W0W0F0F0F0F0F0F0L0W0W0W0W0W0W0W0W0
W0F0W0W0W0W0F0F0F0W0W0W0F0F0F0W0F0W0F0F0W0F0W0F0W0F0W0G0W0F0W0W0W0W0W0W0W0F0L0W0W0W0W0W0W0W0W0W0W0W0
W0F0F0F0F0F0F0F0F0F0F0F0F0F0F0F0F0F0F0F0F0F0F0F0F0F0F0F0F0F0W0W0W0W0W0W0W0W0W0W0W0W0W0W0W0W0W0W0W0W0
