WWWWWWWWWWWWWWWWWWWWWWWWWWWWWWWWWWWWWWWWWWWWWWWWWW
WWWWWWWWWWWWWWWWWWWWWWWWWEWWFFFFFFFFFFFFFFWWWWWWWW
WWWWWWWWWWFFFFFFWWWWWFFFFFFFFFFFFFFFFFFFFFFFFFWWWW
WWWWWFFFFFFFFFFFFWWWWWFFFFFFFFFFFFFFFFFLLFFAFFFWWW
WWWFFFFFFFFFFFFFFFWWWWWWFFFFFFFFFFFFWWWWAFFFFFZFWW
WWWFFFFFFFFFFFFFGFFWWWWWFFWWWWWFFFFFWWWWFFPPPPPFWW
WWFFFFFFFFFWFFFFFFFWWWWWPPWFFWWWWGGGWFFPPPPFFFPFWW
WWFFFFFFFFFFWFFFFFFWWWFFFFFFFFWWWWWGGFFPAPPPPFPFWW
WWFFFFFFFFFFFFWLFFFWWFFFFFFFFFWWWWWWFFFPFPFLPFPFPW
WFFFFFFFFFFFFFWFFFFWWFFFFFFFFFFFFFWWWWWWFPFPPFPFPW
WFFFFFFGFFFFFFFWFFFWWFFFFFFFFFFFFFWWWWWWFFFFFFFFPW
WFFFFFFFFFFFFFFFFFWWWWFFFFFFFFFFFFWWWWWWPPPPPFPPPW
WFFFFFFFFFFFFFFFFFWWWWFFFFFFFFFFFFFWWWFFFFFFFFFFWW
WFWFFFFWAWFFFFFFFWWWWWD4WPPWWWFFFFFFFFFFFFFFFFFFWWW
WFK4WFFFFWFFFFFFFFWWWFFFFFFFFWWFFFFFFFFFFFWWWWWWWWW
WFWFFFFFFFFFFFFFWFFFFFFFFFFFFWWFFFFFFFFWWWWFFWWWWW
WFFFFGFFFFFFFFFWFFFFFFFFFFFFFFWWFFFFWWWWZFFFFFWWWW
WFFFFFFFFFFFFFFWFFFFFFFFFFFFFFFWWWWWWWWCZFFFFFWWWW
WFFFFFFFFFFFFFWFFFFFFFFFFFFFFFFFWWWWWLLFFFFFFFFWWW
WFFFGFFFFFFFFFWFFFFFFFFFFFFFFFFFFWWAAFFFWFFFFFFWWW
WFFFFFFFFFFFFFWFFFFFFFFFFFFFFFFFFWWWWWWWFFFFFFFFWW
WFFFFFFFFFFFFFD3FFFFFFFFFFFFFFFFFFD0FFFFFFFFFWFFFFWW
WFFFWWFFFFFFFFWFFFFFFFFFFFFFFFFFFWFFFFFFFFWFFFFWWW
WFFFFAWFFFFFFFWFFFFFFFFFBFFFFFFFK0WFFFFFFFFWFFGFWWW
WFGFFFWFFFFFFFFWFFFFFFFFFFFFFFFFWWWFFFFFFFWFFFFWWW
WFFFFFFFFFFFFFFWFFFFFFFFFFFFFFFWWWWWPPPWWWFFFFFWWW
WWFFFFFFFFFFFFFWFFFFFFFFFFFFFFFWWWWWFFFWFFFFFFFFWW
WWFFFFFFFFFFWFFWFFFFFFFFFFFFFFFWWWWWFK1FWFFFFFFFWWW
WWFFFFFFFFFWAFFWFFFFFFFFFFFFFWD1WWFWWFFFZFFFFFFWWWW
WWWFFFFFFFFWFFFFWFFFFFFFFFFFWFFFFFPWWWFZFFWWWWWWWW
WWWFFFFFFFFWFFFFWFFFFFFFFFFWFFFFFFPFWWWWWWWWWWWWWW
WWWFFWFFFFFFFFWWWFFFFFFFFFWFPFFFFFPFFFFFFFFFWWWWWW
WWWFFLWFFFFFWWFFFWFFFFFFFFWFPPPPFPPFFFPPPPFFFWWWWW
WWWFFFFWFFWWFFWPPWFFFFFFFWWFFPFFFFPFPPPFFPPAFFWWWW
WWWFFFFFFWWFFFFFFFWWWWWD2WFWFFPFFPPPFPAPFFFPPFFFWWW
WWWWFFFFFWFPPWPCPPFFFWPFPFWFFPPFPFFFPFPFPFFFFFPFWW
WWWWFFFFWWFPFFFFPPPPFFFFPFFWFFPFPFPPPFPFPPPPPFPFWW
WWWWWFWWWFWPFFFFFPFPCPPCPFFFWWPFFFFFFFPFFFFFPFPFWW
WWWWWWFFFPPFCPPWFPFWFFPFPPWPFWPPPPPFPPPPPK2FFPFPFWW
WWWWWWFFPPFFPFFPFPFPFFPFFFFPFFWWFFPFPFFFPPPFPPPFWW
WWWWWWWFCFFPFFWPCPFPFFPWPFFPPFFWFFPCPFPFPFPFFFFFWW
WWWWWWWCPPFPFFFFFPFPPCPPPPCPPFFWPPPFPFPFPFPFPPPFWW
WWWWWWWFFPFFPPFFFFPPPFPWPPFFPFFWPFFFFFPFZFPFPFFFWW
WWWFWWWFFWPFFPPPFFFCFFFFCFFFPFFWPFPPPFPFPPPFPFFWWW
WWFFFWWFFFWPFCFFPPPPPPPPPPFFFPFWPFPLFFFFFFFFPFWWWW
WWFK3FFWFFFFPPPFFFPFFFFFFFPPFFFPFWFFFPPPFPPPFFWWWWW
WWWFFFWWPPPWFFPPFFCPWPPPFPWPPCPFFWFFFFFFLFFFFWWWWW
WWWWFFFFFFFFPPPPPWPPPWPPCPFWWFFFFFWFFFFFFFFWWWWWWW
WWWWWWWWWWPFFFFCFFFFFFFFFPFFFFFFFFFWWWWWWWWWWWWWWW
WWWWWWWWWWWWWWWWWWWWWWWWWWWWWWWWWWWWWWWWWWWWWWWWWW
